111111111111111111111111111111
100000000000000000000000000001
100000000000000000000000000001
100000000000000000000000000001
100000000000000000001110000001
101100000000000000001110000001
101100000000000000001110000001
101100000000000000000100000001
101100000000100000000000000001
100000000000000000000000000001
100000000000000000000000011001
100000000000000000000001100001
100000000000000000000000011001
100000000000000000000000000001
100000000000000000000000000001
100000000000000000000000000001
100000000000010000000000000001
100000000000000000000000001101
100000000000000000000000001101
111111111111111111111111111111